******************************
*                            *
*      ** **       **  **    *
*                   *    *   *
*      *                *    *
*      ***  *    L  **  **   *
*                            *
*    *   **         **  **   *
*    *    *         *    *   *
*    *    *         *    *   *
*    **  **         **   *   *
*                            *
*      ******       ******   *
*                            *
******************************
